[[2, 2, 2, 2, 2, 2, 2, 2, 2, 2, 2, 2, 2, 2, 2, 2, 2, 2],
[2, 8, 1, 1, 1, 1, 1, 1, 1, 1, 1, 1, 1, 1, 1, 1, 1, 2],
[2, 1, 2, 1, 1, 1, 1, 1, 2, 2, 2, 2, 2, 2, 2, 2, 1, 2],
[2, 1, 2, 2, 2, 2, 2, 1, 2, 5, 5, 5, 5, 5, 5, 1, 1, 2],
[2, 1, 6, 6, 6, 6, 2, 2, 2, 5, 2, 2, 2, 2, 2, 1, 1, 2],
[2, 1, 2, 5, 5, 5, 5, 5, 5, 5, 2, 1, 1, 1, 1, 1, 1, 2],
[2, 1, 2, 2, 2, 2, 2, 2, 2, 2, 2, 1, 2, 2, 1, 1, 1, 2],
[2, 1, 2, 1, 1, 1, 1, 2, 1, 1, 1, 1, 2, 5, 1, 2, 6, 2],
[2, 1, 1, 1, 2, 1, 1, 1, 1, 1, 2, 1, 2, 5, 1, 2, 6, 2],
[2, 2, 2, 2, 2, 2, 2, 2, 2, 2, 2, 1, 2, 2, 1, 2, 2, 2],
[1, 2, 1, 1, 1, 1, 1, 1, 1, 1, 1, 1, 1, 1, 1, 2, 6, 2],
[1, 2, 6, 6, 2, 1, 1, 2, 2, 2, 2, 2, 2, 2, 2, 2, 6, 2],
[1, 2, 2, 6, 2, 1, 1, 1, 1, 1, 1, 1, 1, 1, 1, 1, 1, 2],
[1, 1, 2, 6, 2, 1, 1, 2, 2, 2, 2, 2, 2, 1, 1, 1, 1, 2],
[1, 2, 2, 6, 2, 1, 1, 2, 1, 1, 1, 1, 2, 1, 1, 2, 2, 2],
[1, 2, 6, 6, 2, 1, 1, 2, 1, 9, 1, 2, 2, 1, 2, 2, 6, 2],
[1, 2, 6, 6, 2, 1, 1, 2, 1, 1, 1, 1, 1, 1, 6, 6, 6, 2],
[1, 2, 2, 2, 2, 2, 2, 2, 2, 2, 2, 2, 2, 2, 2, 2, 2, 2]
]